1111111111111111111111111111111111111111
1000000011000CC000001111000CCCCC0C001101
1C0000000000000000000000000CCC1110011001
1010E000000000000000000CCCCC0000011110C1
1P0000000000CCC111000000000000000000C001
1000000011000CC000001111000CCCCC0C001101
1C0000000000000000000000000CCC1110011001
10100000000000000000000CCCCC0000011110C1
1P0000000000CCC111000000000000000000C001
1P0000000000CCC111000000000000000000C001
1000000011000CC000001111000CCCCC0C001101
1C0000000000000000000000000CCC1110011001
10100000000000000000000CCCCC0000011110C1
1P0000000000CCC111000000000000000000C001
1P0000000000CCC111000000000000000000C001
1000000011000CC000001111000CCCCC0C001101
1C0000000000000000000000000CCC1110011001
10100000000000000000000CCCCC0000011110C1
1P0000000000CCC111000000000000000000C001
1111111111111111111111111111111111111111