111111111111111
100C0000CC011E1
1C000110011C001
1110000100010C1
10CC00000P0C001
1111111100001C1
111000C00011001
11CC00000010001
1000000C0001111
111111111111111