1111111111
100C001101
1C00011001
1010E010C1
1P0000C001
1111111111



