111111111111111
100C0020CC011E1
1C000110011C001
1110000100010C1
10CC60000P0C001
1111111100001C1
111000C00011001
11CC00000010001
1000000C0001111
10011111C8010C1
14101101100C011
100001C011C0111
101200000110111
1C0006000000C11
111111111111111