1111111111
100C0011E1
1C00011001
10100010C1
1P0060C401
1000000001
1111111111