1111111111
1C2C0011E1
1CC0011801
10100010C1
1P0400C001
10001111C1
1110C06101
1111111111