1111111111
10000211E1
1C00011801
10100010C1
1P0400C001
10001111C1
1110006101
1111111111