1111111111
10P00C00E1
1111111111



