1111111111
1E0C0011E1
1C00011001
1010E010C1
1P0000C001
1111111111



