1111111111
100C0011P1
1C00011001
1010E010C1
1P0000CP01
1111111111



