1111111111
10000011E1
1001011001
1010001001
1P00000001
1111111111