1111111111
100C0011E1
1C00011001
10100010C1
100000C001
1111111111