1111111011
100C0011E1
1C00011001
10100010C1
1P0000C001
1111111111