1111111111
100C0011E1
1C00011001
1010G010C1
1P0000C001
1111111111